//MAP CONVERTED BY dmm2tgm.py THIS HEADER COMMENT PREVENTS RECONVERSION, DO NOT REMOVE
"a" = (
/obj/mapping_helper/wingrille_spawn/auto/reinforced,
/turf/simulated/floor/plating,
/area/space)
"b" = (
/obj/decal/tile_edge/stripe/extra_big{
	dir = 4
	},
/obj/storage/secure/crate/plasma/armory/anti_biological,
/obj/item/gun/flamethrower/assembled/loaded,
/turf/simulated/floor,
/area/space)
"e" = (
/obj/cable{
	icon_state = "4-8"
	},
/obj/cable{
	icon_state = "1-8"
	},
/obj/item/storage/box/flashbang_kit{
	pixel_y = 13
	},
/obj/item/storage/box/flashbang_kit{
	pixel_x = -6;
	pixel_y = 13
	},
/obj/item/chem_grenade/pepper{
	pixel_x = 5;
	pixel_y = 2
	},
/obj/item/chem_grenade/pepper{
	pixel_x = -2;
	pixel_y = 2
	},
/obj/item/chem_grenade/pepper{
	pixel_x = -9;
	pixel_y = 2
	},
/obj/table/auto,
/turf/simulated/floor/black,
/area/space)
"f" = (
/obj/landmark/start/latejoin,
/turf/simulated/floor,
/area/space)
"j" = (
/obj/mapping_helper/wingrille_spawn/auto/reinforced,
/obj/cable{
	icon_state = "0-8"
	},
/turf/simulated/floor/plating,
/area/space)
"k" = (
/obj/mapping_helper/wingrille_spawn/auto/reinforced,
/obj/cable{
	icon_state = "0-4"
	},
/turf/simulated/floor/plating,
/area/space)
"q" = (
/turf/simulated/wall/auto/supernorn,
/area/space)
"w" = (
/turf/simulated/floor,
/area/space)
"z" = (
/obj/landmark/map{
	name = "BATTLEFIELD"
	},
/turf/space,
/area/space)
"A" = (
/obj/machinery/vending/security_ammo,
/turf/simulated/floor,
/area/space)
"E" = (
/turf/space,
/area/space)
"F" = (
/obj/machinery/weapon_stand/phaser_rack,
/turf/simulated/floor,
/area/space)
"I" = (
/obj/random_item_spawner/armory_breaching_supplies,
/turf/simulated/floor,
/area/space)
"K" = (
/obj/machinery/weapon_stand/rifle_rack/recharger,
/turf/simulated/floor,
/area/space)
"W" = (
/obj/mapping_helper/wingrille_spawn/auto/reinforced,
/obj/cable{
	icon_state = "0-8"
	},
/obj/cable{
	icon_state = "0-4"
	},
/turf/simulated/floor/plating,
/area/space)
"Y" = (
/obj/random_item_spawner/armory_goggle_supplies,
/turf/simulated/floor,
/area/space)

(1,1,1) = {"
E
E
E
E
E
E
E
E
E
E
E
E
E
E
E
E
E
E
E
E
E
E
E
E
E
E
E
E
E
E
E
E
E
E
E
E
E
E
E
E
E
E
E
E
E
E
E
E
E
E
E
E
E
E
E
E
E
E
E
E
E
E
E
z
"}
(2,1,1) = {"
E
E
E
E
E
E
E
E
E
E
E
E
E
E
E
E
E
E
E
E
E
E
E
E
E
E
E
E
E
E
E
E
E
E
E
E
E
E
E
E
E
E
E
E
E
E
E
E
E
E
E
E
E
E
E
E
E
E
E
E
E
E
E
E
"}
(3,1,1) = {"
E
E
E
E
E
E
E
E
E
E
E
E
E
E
E
E
E
E
E
E
E
E
E
E
E
E
E
E
E
E
E
E
E
E
E
E
E
E
E
E
E
E
E
E
E
E
E
E
E
E
E
E
E
E
E
E
E
E
E
E
E
E
E
E
"}
(4,1,1) = {"
E
E
E
E
E
E
E
E
E
E
E
E
E
E
E
E
E
E
E
E
E
E
E
E
E
E
E
E
E
E
E
E
E
E
E
E
E
E
E
E
E
E
E
E
E
E
E
E
E
E
E
E
E
E
E
E
E
E
E
E
E
E
E
E
"}
(5,1,1) = {"
E
E
E
E
E
E
E
E
E
E
E
E
E
E
E
E
E
E
E
E
E
E
E
E
E
E
E
E
E
E
E
E
E
E
E
E
E
E
E
E
E
E
E
E
E
E
E
E
E
E
E
E
E
E
E
E
E
E
E
E
E
E
E
E
"}
(6,1,1) = {"
E
E
E
E
E
E
E
E
E
E
E
E
E
E
E
E
E
E
E
E
E
E
E
E
E
E
E
E
E
E
E
E
E
E
E
E
E
E
E
E
E
E
E
E
E
E
E
E
E
E
E
E
E
E
E
E
E
E
E
E
E
E
E
E
"}
(7,1,1) = {"
E
E
E
E
E
E
E
E
E
E
E
E
E
E
E
E
E
E
E
E
E
E
E
E
E
E
E
E
E
E
E
E
E
E
E
E
E
E
E
E
E
E
E
E
E
E
E
E
E
E
E
E
E
E
E
E
E
E
E
E
E
E
E
E
"}
(8,1,1) = {"
E
E
E
E
E
E
E
E
E
E
E
E
E
E
E
E
E
E
E
E
E
E
E
E
E
E
E
E
E
E
E
E
E
E
E
E
E
E
E
E
E
E
E
E
E
E
E
E
E
E
E
E
E
E
E
E
E
E
E
E
E
E
E
E
"}
(9,1,1) = {"
E
E
E
E
E
E
E
E
E
E
E
E
E
E
E
E
E
E
E
E
E
E
E
E
q
q
q
q
q
q
q
q
q
q
q
q
q
q
q
q
q
q
q
q
q
q
q
q
E
E
E
E
E
E
E
E
E
E
E
E
E
E
E
E
"}
(10,1,1) = {"
E
E
E
E
E
E
E
E
E
E
E
E
E
E
E
E
E
E
E
E
E
E
E
E
q
w
w
w
w
w
w
w
w
w
w
w
w
w
w
w
w
w
w
w
w
w
w
q
E
E
E
E
E
E
E
E
E
E
E
E
E
E
E
E
"}
(11,1,1) = {"
E
E
E
E
E
E
E
E
E
E
E
E
E
E
E
E
E
E
E
E
E
E
E
E
q
w
w
w
w
w
w
w
w
w
w
w
w
w
w
w
w
w
w
w
w
w
w
q
E
E
E
E
E
E
E
E
E
E
E
E
E
E
E
E
"}
(12,1,1) = {"
E
E
E
E
E
E
E
E
E
E
E
E
E
E
E
E
E
E
E
E
E
E
E
E
q
w
w
w
w
w
q
a
a
q
q
q
q
q
q
q
q
q
q
q
w
w
w
q
q
q
q
q
q
q
q
q
q
E
E
E
E
E
E
E
"}
(13,1,1) = {"
E
E
E
E
E
E
E
E
E
E
E
E
E
E
E
E
E
E
E
E
E
E
E
E
q
w
w
w
w
w
w
w
w
w
w
w
w
w
w
w
w
w
w
q
w
w
w
w
w
w
w
w
w
w
w
w
q
E
E
E
E
E
E
E
"}
(14,1,1) = {"
E
E
E
E
E
E
E
E
E
E
E
E
E
E
E
E
E
E
E
E
E
E
E
E
q
w
w
w
w
w
w
w
w
w
w
w
w
w
w
w
w
w
w
q
w
w
w
w
w
w
w
w
w
w
w
w
q
E
E
E
E
E
E
E
"}
(15,1,1) = {"
E
E
E
E
E
E
E
E
E
E
E
E
E
E
E
E
E
E
E
E
E
E
E
E
q
w
w
w
w
w
w
w
w
w
w
w
w
w
w
w
w
w
w
q
w
w
w
w
w
w
w
w
w
w
w
w
q
E
E
E
E
E
E
E
"}
(16,1,1) = {"
E
E
E
E
E
E
E
E
E
E
E
E
E
E
E
E
E
E
E
E
E
E
E
E
q
w
w
w
w
w
w
w
w
w
q
w
w
w
w
w
w
w
w
a
w
w
w
w
w
w
w
w
w
w
w
w
q
E
E
E
E
E
E
E
"}
(17,1,1) = {"
E
E
E
E
E
E
E
E
E
E
E
E
E
E
E
E
E
E
E
E
E
E
E
E
q
w
w
w
w
w
w
w
w
w
q
w
w
w
w
w
w
w
w
a
w
w
w
w
w
w
w
w
w
w
w
w
q
E
E
E
E
E
E
E
"}
(18,1,1) = {"
E
E
E
E
E
E
E
E
E
E
E
E
E
E
E
E
E
E
E
E
E
E
E
E
q
a
a
q
q
q
q
w
w
w
q
w
w
w
w
w
w
w
w
q
w
w
w
w
w
w
w
w
w
w
w
w
q
E
E
E
E
E
E
E
"}
(19,1,1) = {"
E
E
E
E
E
E
E
E
E
E
E
E
E
E
E
E
E
E
E
E
E
E
E
E
q
w
w
w
w
w
w
w
w
w
q
w
w
w
w
w
w
q
q
q
w
w
w
w
w
w
w
w
w
w
w
w
q
E
E
E
E
E
E
E
"}
(20,1,1) = {"
E
E
E
E
E
E
E
E
E
E
E
E
E
E
E
E
E
E
E
E
E
E
E
E
q
w
w
w
w
w
w
w
w
w
q
w
w
w
w
w
w
w
w
q
w
w
w
w
w
w
w
w
w
w
w
w
q
E
E
E
E
E
E
E
"}
(21,1,1) = {"
E
E
E
E
E
E
E
E
E
E
E
E
E
E
E
E
E
E
E
E
E
E
E
E
q
w
w
w
w
w
w
w
w
w
a
w
w
w
w
w
w
w
w
q
w
w
w
w
w
w
w
w
w
w
w
w
q
E
E
E
E
E
E
E
"}
(22,1,1) = {"
E
E
E
E
E
E
E
E
E
E
E
E
E
E
E
E
E
E
E
E
E
E
E
E
q
w
w
w
q
q
q
q
q
a
a
w
w
w
w
w
w
w
w
q
w
w
w
w
w
w
w
w
w
w
w
w
q
E
E
E
E
E
E
E
"}
(23,1,1) = {"
E
E
E
E
E
E
E
E
E
E
E
E
E
E
E
E
E
E
E
E
E
E
E
E
q
w
w
w
w
w
w
w
w
w
w
w
q
w
w
w
q
w
w
q
q
q
q
w
w
w
w
w
w
w
w
w
q
E
E
E
E
E
E
E
"}
(24,1,1) = {"
E
E
E
E
E
E
E
E
E
E
E
E
E
E
E
E
E
E
E
E
E
E
E
E
q
w
w
w
w
w
w
w
w
w
w
w
w
w
q
w
w
w
w
k
w
w
q
w
w
w
w
w
w
w
w
w
q
E
E
E
E
E
E
E
"}
(25,1,1) = {"
E
E
E
E
E
E
E
E
E
E
E
E
E
E
E
E
E
E
E
E
E
E
E
E
q
w
q
w
w
w
w
q
w
w
w
w
w
w
w
w
w
w
w
W
w
w
q
q
q
q
w
q
q
q
q
q
q
E
E
E
E
E
E
E
"}
(26,1,1) = {"
E
E
E
E
E
E
E
E
E
E
E
E
E
E
E
E
E
E
E
E
E
E
E
E
q
w
w
w
w
w
w
w
w
q
w
w
w
w
w
w
w
w
w
W
w
w
w
w
w
w
w
w
w
w
w
w
q
E
E
E
E
E
E
E
"}
(27,1,1) = {"
E
E
E
E
E
E
E
E
E
E
E
E
E
E
E
E
E
E
E
E
E
E
E
E
q
w
w
w
w
w
w
w
w
w
w
w
w
w
w
w
w
w
w
W
w
w
w
w
w
w
f
w
w
w
w
w
q
E
E
E
E
E
E
E
"}
(28,1,1) = {"
E
E
E
E
E
E
E
E
E
E
E
E
E
E
E
E
E
E
E
E
E
E
E
E
q
w
w
w
w
w
w
w
w
q
w
w
w
w
w
w
w
w
w
W
w
w
w
w
w
w
w
w
w
w
w
w
q
E
E
E
E
E
E
E
"}
(29,1,1) = {"
E
E
E
E
E
E
E
E
E
E
E
E
E
E
E
E
E
E
E
E
E
E
E
E
q
w
q
w
w
w
w
q
w
w
w
w
w
w
w
w
w
w
w
W
w
w
q
q
q
q
w
q
q
q
q
q
q
E
E
E
E
E
E
E
"}
(30,1,1) = {"
E
E
E
E
E
E
E
E
E
E
E
E
E
E
E
E
E
E
E
E
E
E
E
E
q
w
w
w
w
w
w
w
w
w
w
w
w
w
q
w
w
w
w
j
w
w
q
w
w
w
w
w
w
w
w
w
q
E
E
E
E
E
E
E
"}
(31,1,1) = {"
E
E
E
E
E
E
E
E
E
E
E
E
E
E
E
E
E
E
E
E
E
E
E
E
q
w
w
w
w
w
w
w
w
w
w
w
q
w
w
w
q
w
w
q
q
q
q
w
w
w
w
w
w
w
w
w
q
E
E
E
E
E
E
E
"}
(32,1,1) = {"
E
E
E
E
E
E
E
E
E
E
E
E
E
E
E
E
E
E
E
E
E
E
E
E
q
w
w
w
q
q
q
q
q
a
a
w
w
w
w
w
w
w
w
q
K
w
I
w
w
w
w
w
w
w
w
w
q
E
E
E
E
E
E
E
"}
(33,1,1) = {"
E
E
E
E
E
E
E
E
E
E
E
E
E
E
E
E
E
E
E
E
E
E
E
E
q
w
w
w
w
w
w
w
w
w
a
w
w
w
w
w
w
w
w
q
K
w
I
w
w
w
w
w
w
w
w
w
q
E
E
E
E
E
E
E
"}
(34,1,1) = {"
E
E
E
E
E
E
E
E
E
E
E
E
E
E
E
E
E
E
E
E
E
E
E
E
q
w
w
w
w
w
w
w
w
w
q
w
w
w
w
w
w
w
w
q
K
w
w
w
w
w
w
w
w
w
w
w
q
E
E
E
E
E
E
E
"}
(35,1,1) = {"
E
E
E
E
E
E
E
E
E
E
E
E
E
E
E
E
E
E
E
E
E
E
E
E
q
w
w
w
w
w
w
w
w
w
q
w
w
w
w
w
w
q
q
q
F
w
w
w
w
w
w
w
w
w
w
w
q
E
E
E
E
E
E
E
"}
(36,1,1) = {"
E
E
E
E
E
E
E
E
E
E
E
E
E
E
E
E
E
E
E
E
E
E
E
E
q
a
a
q
q
q
q
w
w
w
q
w
w
w
w
w
w
w
w
q
F
w
Y
w
w
w
w
w
w
w
w
w
q
E
E
E
E
E
E
E
"}
(37,1,1) = {"
E
E
E
E
E
E
E
E
E
E
E
E
E
E
E
E
E
E
E
E
E
E
E
E
q
w
w
w
w
w
w
w
w
w
q
w
w
w
w
w
w
w
w
a
F
w
Y
w
w
w
w
w
w
w
w
w
q
E
E
E
E
E
E
E
"}
(38,1,1) = {"
E
E
E
E
E
E
E
E
E
E
E
E
E
E
E
E
E
E
E
E
E
E
E
E
q
w
w
w
w
w
w
w
w
w
q
w
w
w
w
w
w
w
w
a
w
w
w
w
w
w
w
w
w
w
w
w
q
E
E
E
E
E
E
E
"}
(39,1,1) = {"
E
E
E
E
E
E
E
E
E
E
E
E
E
E
E
E
E
E
E
E
E
E
E
E
q
w
w
w
w
w
w
w
w
w
w
w
w
w
w
w
w
w
w
q
e
w
w
w
w
w
w
w
w
w
w
w
q
E
E
E
E
E
E
E
"}
(40,1,1) = {"
E
E
E
E
E
E
E
E
E
E
E
E
E
E
E
E
E
E
E
E
E
E
E
E
q
w
w
w
w
w
w
w
w
w
w
w
w
w
w
w
w
w
w
q
e
w
w
w
w
w
w
w
w
w
w
w
q
E
E
E
E
E
E
E
"}
(41,1,1) = {"
E
E
E
E
E
E
E
E
E
E
E
E
E
E
E
E
E
E
E
E
E
E
E
E
q
w
w
w
w
w
w
w
w
w
w
w
w
w
w
w
w
w
w
q
w
w
w
w
b
b
e
e
A
A
w
w
q
E
E
E
E
E
E
E
"}
(42,1,1) = {"
E
E
E
E
E
E
E
E
E
E
E
E
E
E
E
E
E
E
E
E
E
E
E
E
q
w
w
w
w
w
q
a
a
q
q
q
q
q
q
q
q
q
q
q
w
w
w
q
q
q
q
q
q
q
q
q
q
E
E
E
E
E
E
E
"}
(43,1,1) = {"
E
E
E
E
E
E
E
E
E
E
E
E
E
E
E
E
E
E
E
E
E
E
E
E
q
w
w
w
w
w
w
w
w
w
w
w
w
w
w
w
w
w
w
w
w
w
w
q
E
E
E
E
E
E
E
E
E
E
E
E
E
E
E
E
"}
(44,1,1) = {"
E
E
E
E
E
E
E
E
E
E
E
E
E
E
E
E
E
E
E
E
E
E
E
E
q
w
w
w
w
w
w
w
w
w
w
w
w
w
w
w
w
w
w
w
w
w
w
q
E
E
E
E
E
E
E
E
E
E
E
E
E
E
E
E
"}
(45,1,1) = {"
E
E
E
E
E
E
E
E
E
E
E
E
E
E
E
E
E
E
E
E
E
E
E
E
q
q
q
q
q
q
q
q
q
q
q
q
q
q
q
q
q
q
q
q
q
q
q
q
E
E
E
E
E
E
E
E
E
E
E
E
E
E
E
E
"}
(46,1,1) = {"
E
E
E
E
E
E
E
E
E
E
E
E
E
E
E
E
E
E
E
E
E
E
E
E
E
E
E
E
E
E
E
E
E
E
E
E
E
E
E
E
E
E
E
E
E
E
E
E
E
E
E
E
E
E
E
E
E
E
E
E
E
E
E
E
"}
(47,1,1) = {"
E
E
E
E
E
E
E
E
E
E
E
E
E
E
E
E
E
E
E
E
E
E
E
E
E
E
E
E
E
E
E
E
E
E
E
E
E
E
E
E
E
E
E
E
E
E
E
E
E
E
E
E
E
E
E
E
E
E
E
E
E
E
E
E
"}
(48,1,1) = {"
E
E
E
E
E
E
E
E
E
E
E
E
E
E
E
E
E
E
E
E
E
E
E
E
E
E
E
E
E
E
E
E
E
E
E
E
E
E
E
E
E
E
E
E
E
E
E
E
E
E
E
E
E
E
E
E
E
E
E
E
E
E
E
E
"}
(49,1,1) = {"
E
E
E
E
E
E
E
E
E
E
E
E
E
E
E
E
E
E
E
E
E
E
E
E
E
E
E
E
E
E
E
E
E
E
E
E
E
E
E
E
E
E
E
E
E
E
E
E
E
E
E
E
E
E
E
E
E
E
E
E
E
E
E
E
"}
(50,1,1) = {"
E
E
E
E
E
E
E
E
E
E
E
E
E
E
E
E
E
E
E
E
E
E
E
E
E
E
E
E
E
E
E
E
E
E
E
E
E
E
E
E
E
E
E
E
E
E
E
E
E
E
E
E
E
E
E
E
E
E
E
E
E
E
E
E
"}
(51,1,1) = {"
E
E
E
E
E
E
E
E
E
E
E
E
E
E
E
E
E
E
E
E
E
E
E
E
E
E
E
E
E
E
E
E
E
E
E
E
E
E
E
E
E
E
E
E
E
E
E
E
E
E
E
E
E
E
E
E
E
E
E
E
E
E
E
E
"}
(52,1,1) = {"
E
E
E
E
E
E
E
E
E
E
E
E
E
E
E
E
E
E
E
E
E
E
E
E
E
E
E
E
E
E
E
E
E
E
E
E
E
E
E
E
E
E
E
E
E
E
E
E
E
E
E
E
E
E
E
E
E
E
E
E
E
E
E
E
"}
(53,1,1) = {"
E
E
E
E
E
E
E
E
E
E
E
E
E
E
E
E
E
E
E
E
E
E
E
E
E
E
E
E
E
E
E
E
E
E
E
E
E
E
E
E
E
E
E
E
E
E
E
E
E
E
E
E
E
E
E
E
E
E
E
E
E
E
E
E
"}
(54,1,1) = {"
E
E
E
E
E
E
E
E
E
E
E
E
E
E
E
E
E
E
E
E
E
E
E
E
E
E
E
E
E
E
E
E
E
E
E
E
E
E
E
E
E
E
E
E
E
E
E
E
E
E
E
E
E
E
E
E
E
E
E
E
E
E
E
E
"}
(55,1,1) = {"
E
E
E
E
E
E
E
E
E
E
E
E
E
E
E
E
E
E
E
E
E
E
E
E
E
E
E
E
E
E
E
E
E
E
E
E
E
E
E
E
E
E
E
E
E
E
E
E
E
E
E
E
E
E
E
E
E
E
E
E
E
E
E
E
"}
(56,1,1) = {"
E
E
E
E
E
E
E
E
E
E
E
E
E
E
E
E
E
E
E
E
E
E
E
E
E
E
E
E
E
E
E
E
E
E
E
E
E
E
E
E
E
E
E
E
E
E
E
E
E
E
E
E
E
E
E
E
E
E
E
E
E
E
E
E
"}
(57,1,1) = {"
E
E
E
E
E
E
E
E
E
E
E
E
E
E
E
E
E
E
E
E
E
E
E
E
E
E
E
E
E
E
E
E
E
E
E
E
E
E
E
E
E
E
E
E
E
E
E
E
E
E
E
E
E
E
E
E
E
E
E
E
E
E
E
E
"}
(58,1,1) = {"
E
E
E
E
E
E
E
E
E
E
E
E
E
E
E
E
E
E
E
E
E
E
E
E
E
E
E
E
E
E
E
E
E
E
E
E
E
E
E
E
E
E
E
E
E
E
E
E
E
E
E
E
E
E
E
E
E
E
E
E
E
E
E
E
"}
(59,1,1) = {"
E
E
E
E
E
E
E
E
E
E
E
E
E
E
E
E
E
E
E
E
E
E
E
E
E
E
E
E
E
E
E
E
E
E
E
E
E
E
E
E
E
E
E
E
E
E
E
E
E
E
E
E
E
E
E
E
E
E
E
E
E
E
E
E
"}
(60,1,1) = {"
E
E
E
E
E
E
E
E
E
E
E
E
E
E
E
E
E
E
E
E
E
E
E
E
E
E
E
E
E
E
E
E
E
E
E
E
E
E
E
E
E
E
E
E
E
E
E
E
E
E
E
E
E
E
E
E
E
E
E
E
E
E
E
E
"}
(61,1,1) = {"
E
E
E
E
E
E
E
E
E
E
E
E
E
E
E
E
E
E
E
E
E
E
E
E
E
E
E
E
E
E
E
E
E
E
E
E
E
E
E
E
E
E
E
E
E
E
E
E
E
E
E
E
E
E
E
E
E
E
E
E
E
E
E
E
"}
(62,1,1) = {"
E
E
E
E
E
E
E
E
E
E
E
E
E
E
E
E
E
E
E
E
E
E
E
E
E
E
E
E
E
E
E
E
E
E
E
E
E
E
E
E
E
E
E
E
E
E
E
E
E
E
E
E
E
E
E
E
E
E
E
E
E
E
E
E
"}
(63,1,1) = {"
E
E
E
E
E
E
E
E
E
E
E
E
E
E
E
E
E
E
E
E
E
E
E
E
E
E
E
E
E
E
E
E
E
E
E
E
E
E
E
E
E
E
E
E
E
E
E
E
E
E
E
E
E
E
E
E
E
E
E
E
E
E
E
E
"}
(64,1,1) = {"
E
E
E
E
E
E
E
E
E
E
E
E
E
E
E
E
E
E
E
E
E
E
E
E
E
E
E
E
E
E
E
E
E
E
E
E
E
E
E
E
E
E
E
E
E
E
E
E
E
E
E
E
E
E
E
E
E
E
E
E
E
E
E
E
"}
