//MAP CONVERTED BY dmm2tgm.py THIS HEADER COMMENT PREVENTS RECONVERSION, DO NOT REMOVE
"at" = (
/obj/machinery/light{
	dir = 1
	},
/turf/simulated/floor,
/area/station/hallway/primary/central)
"aH" = (
/obj/mapping_helper/wingrille_spawn/auto/reinforced,
/obj/cable{
	icon_state = "4-8"
	},
/turf/simulated/floor/plating,
/area/station/hallway/primary/central)
"bl" = (
/obj/cable{
	icon_state = "1-2"
	},
/turf/simulated/floor/plating,
/area/station/hallway/primary/central)
"bJ" = (
/turf/simulated/floor/yellow,
/area/station/hallway/primary/central)
"ch" = (
/obj/machinery/door/airlock/pyro/glass,
/obj/disposalpipe/segment,
/obj/cable{
	icon_state = "1-2"
	},
/obj/mapping_helper/firedoor_spawn,
/obj/decal/stripe_caution,
/obj/cable/orange{
	icon_state = "1-2"
	},
/turf/simulated/floor,
/area/station/hallway/primary/central)
"cx" = (
/obj/cable/orange{
	icon_state = "4-8"
	},
/turf/simulated/floor,
/area/station/hallway/primary/central)
"cH" = (
/obj/machinery/drill/drill,
/turf/simulated/floor/plating,
/area/station/hallway/primary/central)
"dF" = (
/obj/machinery/power/data_terminal,
/obj/cable{
	icon_state = "0-2"
	},
/obj/cable,
/obj/machinery/computer/drill{
	dir = 8
	},
/turf/simulated/floor/plating,
/area/station/hallway/primary/central)
"hA" = (
/obj/cable{
	icon_state = "4-8"
	},
/turf/simulated/floor,
/area/station/hallway/primary/central)
"hL" = (
/obj/table/auto,
/obj/item/sheet/steel{
	amount = 50
	},
/obj/item/sheet/steel{
	amount = 50
	},
/obj/item/sheet/steel{
	amount = 50;
	pixel_x = 2;
	pixel_y = -1
	},
/obj/item/sheet/steel{
	amount = 50;
	pixel_x = -1;
	pixel_y = 2
	},
/obj/item/storage/box/cablesbox{
	pixel_x = -2;
	pixel_y = 2
	},
/turf/simulated/floor/yellow,
/area/station/hallway/primary/central)
"jj" = (
/obj/landmark/start/latejoin,
/turf/simulated/floor,
/area/station/hallway/primary/central)
"jW" = (
/obj/mapping_helper/wingrille_spawn/auto/reinforced,
/obj/cable{
	icon_state = "1-2"
	},
/turf/simulated/floor/plating,
/area/station/hallway/primary/central)
"kd" = (
/obj/cable/orange{
	icon_state = "1-2"
	},
/turf/simulated/floor,
/area/station/hallway/primary/central)
"kA" = (
/turf/simulated/wall/auto/supernorn,
/area/station/hallway/primary/central)
"kR" = (
/obj/cable{
	icon_state = "1-2"
	},
/turf/simulated/floor,
/area/station/hallway/primary/central)
"mk" = (
/obj/cable{
	icon_state = "4-8"
	},
/turf/simulated/floor/plating,
/area/station/hallway/primary/central)
"mS" = (
/obj/machinery/light,
/turf/simulated/floor,
/area/station/hallway/primary/central)
"po" = (
/obj/machinery/door/airlock/pyro/external,
/obj/mapping_helper/firedoor_spawn,
/obj/mapping_helper/airlock/cycler{
	cycle_id = "escape2";
	enter_id = "main";
	name = "Escape"
	},
/turf/simulated/floor,
/area/station/hallway/primary/central)
"ps" = (
/obj/machinery/drill/component_storage,
/turf/simulated/floor/plating,
/area/station/hallway/primary/central)
"qF" = (
/obj/item/device/drill/drillhead,
/obj/item/device/drill/drillhead,
/obj/item/device/drill/drillhead,
/obj/item/device/drill/drillhead,
/obj/item/device/drill/drillhead,
/obj/item/device/drill/drillhead,
/obj/item/device/drill/drillhead,
/obj/item/device/drill/drillhead,
/obj/item/device/drill/drillhead,
/obj/item/device/drill/drillhead,
/obj/cable{
	icon_state = "4-8"
	},
/turf/simulated/floor/plating,
/area/station/hallway/primary/central)
"tL" = (
/obj/mapping_helper/wingrille_spawn/auto/reinforced,
/obj/cable{
	icon_state = "2-8"
	},
/turf/simulated/floor/plating,
/area/station/hallway/primary/central)
"vg" = (
/obj/cable{
	icon_state = "2-8"
	},
/turf/simulated/floor/plating,
/area/station/hallway/primary/central)
"wg" = (
/obj/machinery/power/apc/autoname_north,
/obj/cable{
	icon_state = "0-2"
	},
/turf/simulated/floor/plating,
/area/station/hallway/primary/central)
"wU" = (
/obj/machinery/light{
	dir = 8
	},
/turf/simulated/floor/yellow,
/area/station/hallway/primary/central)
"zm" = (
/obj/machinery/power/data_terminal,
/obj/cable,
/obj/cable{
	icon_state = "0-2"
	},
/turf/simulated/floor/plating,
/area/station/hallway/primary/central)
"Bf" = (
/obj/table/auto,
/obj/item/storage/toolbox/electrical{
	pixel_x = -5;
	pixel_y = 9
	},
/obj/item/device/multitool{
	pixel_x = 9;
	pixel_y = 8
	},
/obj/item/clothing/gloves/yellow{
	pixel_x = -2;
	pixel_y = -1
	},
/turf/simulated/floor/yellow,
/area/station/hallway/primary/central)
"Bp" = (
/obj/machinery/power/terminal{
	dir = 4
	},
/obj/cable/orange{
	icon_state = "0-2"
	},
/turf/simulated/floor/plating,
/area/station/hallway/primary/central)
"BB" = (
/turf/simulated/floor/plating,
/area/station/hallway/primary/central)
"BJ" = (
/obj/storage/crate/rcd/CE,
/turf/simulated/floor/yellow,
/area/station/hallway/primary/central)
"DD" = (
/obj/machinery/power/data_terminal,
/obj/cable{
	icon_state = "0-2"
	},
/obj/cable,
/obj/machinery/computer/drill/ground_map{
	dir = 8
	},
/turf/simulated/floor/plating,
/area/station/hallway/primary/central)
"FK" = (
/turf/space,
/area/space)
"Gz" = (
/obj/cable/orange{
	icon_state = "1-4"
	},
/turf/simulated/floor,
/area/station/hallway/primary/central)
"GE" = (
/obj/mapping_helper/wingrille_spawn/auto/reinforced,
/turf/simulated/floor/plating,
/area/station/hallway/primary/central)
"Lh" = (
/obj/machinery/light{
	dir = 8
	},
/turf/simulated/floor/plating,
/area/station/hallway/primary/central)
"Mf" = (
/obj/landmark/map{
	name = "DRILL"
	},
/turf/space,
/area/space)
"MB" = (
/obj/machinery/drill/engine,
/turf/simulated/floor/plating,
/area/station/hallway/primary/central)
"MW" = (
/obj/item/device/drill/pipe,
/obj/item/device/drill/pipe,
/obj/item/device/drill/pipe,
/obj/item/device/drill/pipe,
/obj/item/device/drill/pipe,
/obj/item/device/drill/pipe,
/obj/item/device/drill/pipe,
/obj/item/device/drill/pipe,
/obj/item/device/drill/pipe,
/obj/item/device/drill/pipe,
/obj/item/device/drill/pipe,
/obj/item/device/drill/pipe,
/obj/item/device/drill/pipe,
/obj/item/device/drill/pipe,
/obj/item/device/drill/pipe,
/obj/item/device/drill/pipe,
/obj/cable{
	icon_state = "4-8"
	},
/turf/simulated/floor/plating,
/area/station/hallway/primary/central)
"Pz" = (
/obj/cable{
	icon_state = "1-4"
	},
/turf/simulated/floor,
/area/station/hallway/primary/central)
"Qg" = (
/obj/machinery/power/data_terminal,
/obj/cable,
/turf/simulated/floor/plating,
/area/station/hallway/primary/central)
"QR" = (
/obj/cable/orange{
	icon_state = "0-8"
	},
/turf/simulated/floor/plating,
/area/station/hallway/primary/central)
"Ri" = (
/obj/table/auto,
/obj/item/storage/toolbox/mechanical{
	pixel_x = -5;
	pixel_y = 9
	},
/obj/item/device/t_scanner{
	pixel_x = 10;
	pixel_y = 3
	},
/obj/item/wrench{
	pixel_y = 5
	},
/turf/simulated/floor/yellow,
/area/station/hallway/primary/central)
"Sh" = (
/obj/machinery/light{
	dir = 4
	},
/obj/cable{
	icon_state = "4-8"
	},
/turf/simulated/floor/yellow,
/area/station/hallway/primary/central)
"SR" = (
/obj/machinery/light{
	dir = 4
	},
/turf/simulated/floor,
/area/station/hallway/primary/central)
"TH" = (
/obj/cable/orange{
	icon_state = "4-8"
	},
/turf/simulated/floor/yellow,
/area/station/hallway/primary/central)
"TZ" = (
/obj/cable{
	icon_state = "1-4"
	},
/turf/simulated/floor/plating,
/area/station/hallway/primary/central)
"Us" = (
/obj/machinery/light{
	dir = 4
	},
/obj/cable{
	icon_state = "4-8"
	},
/turf/simulated/floor/plating,
/area/station/hallway/primary/central)
"US" = (
/obj/item/device/drill/lining,
/obj/item/device/drill/lining,
/obj/item/device/drill/lining,
/obj/item/device/drill/lining,
/obj/item/device/drill/lining,
/obj/item/device/drill/lining,
/obj/item/device/drill/lining,
/obj/item/device/drill/lining,
/obj/item/device/drill/lining,
/obj/item/device/drill/lining,
/obj/item/device/drill/lining,
/obj/item/device/drill/lining,
/obj/item/device/drill/lining,
/obj/item/device/drill/lining,
/obj/cable{
	icon_state = "4-8"
	},
/turf/simulated/floor/plating,
/area/station/hallway/primary/central)
"VH" = (
/obj/cable{
	icon_state = "1-8"
	},
/turf/simulated/floor/plating,
/area/station/hallway/primary/central)
"Wt" = (
/obj/machinery/power/smes{
	charge = 1e+007;
	chargelevel = 15000;
	output = 10000
	},
/obj/cable,
/obj/cable{
	icon_state = "0-2"
	},
/turf/simulated/floor/plating,
/area/station/hallway/primary/central)
"WC" = (
/turf/simulated/floor,
/area/station/hallway/primary/central)
"Xe" = (
/obj/machinery/light{
	dir = 4
	},
/turf/simulated/floor/yellow,
/area/station/hallway/primary/central)
"Xz" = (
/obj/machinery/light{
	dir = 8
	},
/obj/cable{
	icon_state = "0-2"
	},
/obj/cable{
	icon_state = "0-4"
	},
/obj/cable{
	icon_state = "0-8"
	},
/turf/simulated/floor/plating,
/area/station/hallway/primary/central)
"XB" = (
/obj/machinery/power/data_terminal,
/obj/cable{
	icon_state = "0-2"
	},
/obj/cable{
	icon_state = "0-4"
	},
/turf/simulated/floor/plating,
/area/station/hallway/primary/central)
"YB" = (
/obj/machinery/light{
	dir = 8
	},
/turf/simulated/floor,
/area/station/hallway/primary/central)
"YD" = (
/obj/machinery/power/data_terminal,
/obj/cable{
	icon_state = "0-2"
	},
/obj/cable,
/turf/simulated/floor/plating,
/area/station/hallway/primary/central)
"Za" = (
/obj/machinery/light{
	dir = 4
	},
/turf/simulated/floor/plating,
/area/station/hallway/primary/central)

(1,1,1) = {"
FK
FK
FK
FK
FK
FK
FK
FK
FK
FK
FK
FK
FK
FK
FK
FK
FK
FK
FK
FK
FK
FK
FK
FK
FK
FK
FK
FK
FK
FK
FK
FK
FK
FK
FK
FK
FK
FK
FK
FK
FK
FK
FK
FK
FK
FK
FK
FK
FK
FK
FK
FK
FK
FK
FK
FK
FK
FK
FK
FK
FK
FK
FK
Mf
"}
(2,1,1) = {"
FK
FK
FK
FK
FK
FK
FK
FK
FK
FK
FK
FK
FK
FK
FK
FK
FK
FK
FK
FK
FK
FK
FK
FK
FK
FK
FK
FK
FK
FK
FK
FK
FK
FK
FK
FK
FK
FK
FK
FK
FK
FK
FK
FK
FK
FK
FK
FK
FK
FK
FK
FK
FK
FK
FK
FK
FK
FK
FK
FK
FK
FK
FK
FK
"}
(3,1,1) = {"
FK
FK
FK
FK
FK
FK
FK
FK
FK
FK
FK
FK
FK
FK
FK
FK
FK
FK
FK
FK
FK
FK
FK
FK
FK
FK
FK
FK
FK
FK
FK
FK
FK
FK
FK
FK
FK
FK
FK
FK
FK
FK
FK
FK
FK
FK
FK
FK
FK
FK
FK
FK
FK
FK
FK
FK
FK
FK
FK
FK
FK
FK
FK
FK
"}
(4,1,1) = {"
FK
FK
FK
FK
FK
FK
FK
FK
FK
FK
FK
FK
FK
FK
FK
FK
FK
FK
FK
FK
FK
FK
FK
FK
FK
FK
FK
FK
FK
FK
FK
FK
FK
FK
FK
FK
FK
FK
FK
FK
FK
FK
FK
FK
FK
FK
FK
FK
FK
FK
FK
FK
FK
FK
FK
FK
FK
FK
FK
FK
FK
FK
FK
FK
"}
(5,1,1) = {"
FK
FK
FK
FK
FK
FK
FK
FK
FK
FK
FK
FK
FK
FK
FK
FK
FK
FK
FK
FK
FK
FK
FK
FK
FK
FK
FK
FK
FK
FK
FK
FK
FK
FK
FK
FK
FK
FK
FK
FK
kA
kA
kA
kA
kA
kA
kA
kA
kA
kA
kA
kA
kA
kA
kA
kA
kA
kA
kA
kA
kA
kA
FK
FK
"}
(6,1,1) = {"
FK
FK
FK
FK
FK
FK
FK
FK
FK
FK
FK
FK
FK
FK
FK
FK
FK
FK
FK
FK
FK
FK
FK
FK
FK
FK
FK
FK
FK
FK
FK
FK
FK
FK
FK
FK
FK
FK
FK
FK
kA
BB
Lh
BB
GE
WC
WC
WC
YB
WC
WC
WC
WC
WC
YB
WC
WC
WC
WC
YB
WC
kA
FK
FK
"}
(7,1,1) = {"
FK
FK
FK
FK
FK
FK
FK
FK
FK
FK
FK
FK
FK
FK
FK
FK
FK
FK
FK
FK
FK
FK
FK
FK
FK
FK
FK
FK
FK
FK
FK
FK
FK
FK
FK
FK
FK
FK
FK
FK
kA
wg
TZ
Bp
ch
kd
kd
Gz
WC
WC
WC
WC
WC
WC
WC
WC
WC
WC
WC
WC
WC
kA
FK
FK
"}
(8,1,1) = {"
FK
FK
FK
FK
FK
FK
FK
FK
FK
FK
FK
FK
FK
FK
FK
FK
FK
FK
FK
FK
FK
FK
FK
FK
FK
FK
FK
FK
FK
FK
FK
FK
FK
FK
FK
FK
FK
FK
FK
FK
kA
BB
vg
Wt
jW
kR
Pz
cx
WC
WC
WC
WC
WC
WC
WC
WC
WC
WC
WC
WC
WC
kA
FK
FK
"}
(9,1,1) = {"
FK
FK
FK
FK
FK
FK
FK
FK
FK
FK
FK
FK
FK
FK
FK
FK
FK
FK
FK
FK
FK
FK
FK
FK
FK
FK
FK
FK
FK
FK
FK
FK
FK
FK
FK
FK
FK
FK
FK
FK
kA
GE
kA
GE
kA
WC
hA
cx
WC
WC
WC
WC
WC
WC
WC
WC
WC
WC
WC
WC
WC
kA
FK
FK
"}
(10,1,1) = {"
FK
FK
FK
FK
FK
FK
FK
FK
FK
FK
FK
FK
FK
FK
FK
FK
FK
FK
FK
FK
FK
FK
FK
FK
FK
FK
FK
FK
FK
FK
FK
FK
FK
FK
FK
FK
FK
FK
FK
FK
kA
WC
YB
WC
WC
WC
hA
cx
WC
WC
WC
WC
WC
WC
WC
WC
WC
WC
WC
WC
WC
kA
FK
FK
"}
(11,1,1) = {"
FK
FK
FK
FK
FK
FK
FK
FK
FK
FK
FK
FK
FK
FK
FK
FK
FK
FK
FK
FK
FK
FK
FK
FK
FK
FK
FK
FK
FK
FK
FK
FK
FK
FK
FK
FK
FK
FK
FK
FK
kA
WC
WC
WC
WC
WC
hA
cx
WC
WC
WC
WC
WC
WC
WC
WC
WC
WC
WC
WC
WC
kA
FK
FK
"}
(12,1,1) = {"
FK
FK
FK
FK
FK
FK
FK
FK
FK
FK
FK
FK
FK
FK
FK
FK
FK
FK
FK
FK
FK
FK
FK
FK
FK
FK
FK
FK
FK
FK
FK
FK
FK
FK
FK
FK
FK
FK
FK
FK
kA
WC
WC
WC
jj
bJ
Sh
TH
bJ
bJ
bJ
bJ
bJ
Xe
bJ
WC
WC
WC
WC
WC
WC
kA
FK
FK
"}
(13,1,1) = {"
FK
FK
FK
FK
FK
FK
FK
FK
FK
FK
FK
FK
FK
FK
FK
FK
FK
FK
FK
FK
FK
FK
FK
FK
FK
FK
FK
FK
FK
FK
FK
FK
FK
FK
FK
FK
FK
FK
FK
FK
kA
WC
WC
WC
WC
bJ
aH
QR
XB
dF
DD
YD
Qg
GE
bJ
WC
WC
WC
WC
WC
mS
kA
FK
FK
"}
(14,1,1) = {"
FK
FK
FK
FK
FK
FK
FK
FK
FK
FK
FK
FK
FK
FK
FK
FK
FK
FK
FK
FK
FK
FK
FK
FK
FK
FK
FK
FK
FK
FK
FK
FK
FK
FK
FK
FK
FK
FK
FK
FK
kA
WC
WC
WC
WC
bJ
Xz
bl
VH
BB
BB
BB
BB
Lh
bJ
WC
WC
WC
WC
WC
WC
kA
FK
FK
"}
(15,1,1) = {"
FK
FK
FK
FK
FK
FK
FK
FK
FK
FK
FK
FK
FK
FK
FK
FK
FK
FK
FK
FK
FK
FK
FK
FK
FK
FK
FK
FK
FK
FK
FK
FK
FK
FK
FK
FK
FK
FK
FK
FK
GE
WC
Bf
bJ
bJ
bJ
MW
BB
bJ
BB
BB
bJ
BB
BB
bJ
WC
WC
WC
WC
WC
WC
kA
FK
FK
"}
(16,1,1) = {"
FK
FK
FK
FK
FK
FK
FK
FK
FK
FK
FK
FK
FK
FK
FK
FK
FK
FK
FK
FK
FK
FK
FK
FK
FK
FK
FK
FK
FK
FK
FK
FK
FK
FK
FK
FK
FK
FK
FK
FK
po
WC
Ri
bJ
bJ
bJ
qF
BB
BB
BB
BB
BB
ps
BB
bJ
WC
WC
WC
WC
WC
WC
kA
FK
FK
"}
(17,1,1) = {"
FK
FK
FK
FK
FK
FK
FK
FK
FK
FK
FK
FK
FK
FK
FK
FK
FK
FK
FK
FK
FK
FK
FK
FK
FK
FK
FK
FK
FK
FK
FK
FK
FK
FK
FK
FK
FK
FK
FK
FK
GE
at
hL
bJ
bJ
bJ
US
BB
BB
cH
BB
BB
BB
BB
bJ
WC
WC
WC
WC
WC
WC
kA
FK
FK
"}
(18,1,1) = {"
FK
FK
FK
FK
FK
FK
FK
FK
FK
FK
FK
FK
FK
FK
FK
FK
FK
FK
FK
FK
FK
FK
FK
FK
FK
FK
FK
FK
FK
FK
FK
FK
FK
FK
FK
FK
FK
FK
FK
FK
GE
WC
BJ
bJ
bJ
bJ
mk
BB
bJ
BB
BB
bJ
BB
BB
bJ
WC
WC
WC
WC
WC
WC
kA
FK
FK
"}
(19,1,1) = {"
FK
FK
FK
FK
FK
FK
FK
FK
FK
FK
FK
FK
FK
FK
FK
FK
FK
FK
FK
FK
FK
FK
FK
FK
FK
FK
FK
FK
FK
FK
FK
FK
FK
FK
FK
FK
FK
FK
FK
FK
kA
WC
WC
WC
WC
bJ
Us
BB
BB
BB
MB
BB
BB
Za
bJ
WC
WC
WC
WC
WC
WC
kA
FK
FK
"}
(20,1,1) = {"
FK
FK
FK
FK
FK
FK
FK
FK
FK
FK
FK
FK
FK
FK
FK
FK
FK
FK
FK
FK
FK
FK
FK
FK
FK
FK
FK
FK
FK
FK
FK
FK
FK
FK
FK
FK
FK
FK
FK
FK
kA
WC
WC
WC
WC
bJ
tL
zm
zm
BB
BB
zm
zm
GE
bJ
WC
WC
WC
WC
WC
WC
kA
FK
FK
"}
(21,1,1) = {"
FK
FK
FK
FK
FK
FK
FK
FK
FK
FK
FK
FK
FK
FK
FK
FK
FK
FK
FK
FK
FK
FK
FK
FK
FK
FK
FK
FK
FK
FK
FK
FK
FK
FK
FK
FK
FK
FK
FK
FK
kA
WC
WC
WC
WC
bJ
wU
bJ
bJ
bJ
bJ
bJ
bJ
wU
bJ
WC
WC
WC
WC
WC
WC
kA
FK
FK
"}
(22,1,1) = {"
FK
FK
FK
FK
FK
FK
FK
FK
FK
FK
FK
FK
FK
FK
FK
FK
FK
FK
FK
FK
FK
FK
FK
FK
FK
FK
FK
FK
FK
FK
FK
FK
FK
FK
FK
FK
FK
FK
FK
FK
kA
at
WC
WC
WC
WC
WC
WC
WC
WC
WC
WC
WC
WC
WC
WC
WC
WC
WC
WC
mS
kA
FK
FK
"}
(23,1,1) = {"
FK
FK
FK
FK
FK
FK
FK
FK
FK
FK
FK
FK
FK
FK
FK
FK
FK
FK
FK
FK
FK
FK
FK
FK
FK
FK
FK
FK
FK
FK
FK
FK
FK
FK
FK
FK
FK
FK
FK
FK
kA
WC
WC
WC
WC
WC
WC
WC
WC
WC
WC
WC
WC
WC
WC
WC
WC
WC
WC
WC
WC
kA
FK
FK
"}
(24,1,1) = {"
FK
FK
FK
FK
FK
FK
FK
FK
FK
FK
FK
FK
FK
FK
FK
FK
FK
FK
FK
FK
FK
FK
FK
FK
FK
FK
FK
FK
FK
FK
FK
FK
FK
FK
FK
FK
FK
FK
FK
FK
kA
WC
WC
WC
WC
WC
WC
WC
WC
WC
WC
WC
WC
WC
WC
WC
WC
WC
WC
WC
WC
kA
FK
FK
"}
(25,1,1) = {"
FK
FK
FK
FK
FK
FK
FK
FK
FK
FK
FK
FK
FK
FK
FK
FK
FK
FK
FK
FK
FK
FK
FK
FK
FK
FK
FK
FK
FK
FK
FK
FK
FK
FK
FK
FK
FK
FK
FK
FK
kA
WC
WC
WC
WC
WC
WC
WC
WC
WC
WC
WC
WC
WC
WC
WC
WC
WC
WC
WC
WC
kA
FK
FK
"}
(26,1,1) = {"
FK
FK
FK
FK
FK
FK
FK
FK
FK
FK
FK
FK
FK
FK
FK
FK
FK
FK
FK
FK
FK
FK
FK
FK
FK
FK
FK
FK
FK
FK
FK
FK
FK
FK
FK
FK
FK
FK
FK
FK
kA
WC
WC
WC
WC
WC
WC
WC
WC
WC
WC
WC
WC
WC
WC
WC
WC
WC
WC
WC
WC
kA
FK
FK
"}
(27,1,1) = {"
FK
FK
FK
FK
FK
FK
FK
FK
FK
FK
FK
FK
FK
FK
FK
FK
FK
FK
FK
FK
FK
FK
FK
FK
FK
FK
FK
FK
FK
FK
FK
FK
FK
FK
FK
FK
FK
FK
FK
FK
kA
WC
WC
WC
WC
WC
WC
WC
WC
WC
WC
WC
WC
WC
WC
WC
WC
WC
WC
WC
WC
kA
FK
FK
"}
(28,1,1) = {"
FK
FK
FK
FK
FK
FK
FK
FK
FK
FK
FK
FK
FK
FK
FK
FK
FK
FK
FK
FK
FK
FK
FK
FK
FK
FK
FK
FK
FK
FK
FK
FK
FK
FK
FK
FK
FK
FK
FK
FK
kA
WC
WC
WC
WC
WC
WC
WC
WC
WC
WC
WC
WC
WC
WC
WC
WC
WC
WC
WC
WC
kA
FK
FK
"}
(29,1,1) = {"
FK
FK
FK
FK
FK
FK
FK
FK
FK
FK
FK
FK
FK
FK
FK
FK
FK
FK
FK
FK
FK
FK
FK
FK
FK
FK
FK
FK
FK
FK
FK
FK
FK
FK
FK
FK
FK
FK
FK
FK
kA
WC
SR
WC
WC
WC
WC
WC
SR
WC
WC
WC
WC
SR
WC
WC
WC
SR
WC
WC
WC
kA
FK
FK
"}
(30,1,1) = {"
FK
FK
FK
FK
FK
FK
FK
FK
FK
FK
FK
FK
FK
FK
FK
FK
FK
FK
FK
FK
FK
FK
FK
FK
FK
FK
FK
FK
FK
FK
FK
FK
FK
FK
FK
FK
FK
FK
FK
FK
kA
kA
kA
kA
kA
kA
kA
kA
kA
kA
kA
kA
kA
kA
kA
kA
kA
kA
kA
kA
kA
kA
FK
FK
"}
(31,1,1) = {"
FK
FK
FK
FK
FK
FK
FK
FK
FK
FK
FK
FK
FK
FK
FK
FK
FK
FK
FK
FK
FK
FK
FK
FK
FK
FK
FK
FK
FK
FK
FK
FK
FK
FK
FK
FK
FK
FK
FK
FK
FK
FK
FK
FK
FK
FK
FK
FK
FK
FK
FK
FK
FK
FK
FK
FK
FK
FK
FK
FK
FK
FK
FK
FK
"}
(32,1,1) = {"
FK
FK
FK
FK
FK
FK
FK
FK
FK
FK
FK
FK
FK
FK
FK
FK
FK
FK
FK
FK
FK
FK
FK
FK
FK
FK
FK
FK
FK
FK
FK
FK
FK
FK
FK
FK
FK
FK
FK
FK
FK
FK
FK
FK
FK
FK
FK
FK
FK
FK
FK
FK
FK
FK
FK
FK
FK
FK
FK
FK
FK
FK
FK
FK
"}
(33,1,1) = {"
FK
FK
FK
FK
FK
FK
FK
FK
FK
FK
FK
FK
FK
FK
FK
FK
FK
FK
FK
FK
FK
FK
FK
FK
FK
FK
FK
FK
FK
FK
FK
FK
FK
FK
FK
FK
FK
FK
FK
FK
FK
FK
FK
FK
FK
FK
FK
FK
FK
FK
FK
FK
FK
FK
FK
FK
FK
FK
FK
FK
FK
FK
FK
FK
"}
(34,1,1) = {"
FK
FK
FK
FK
FK
FK
FK
FK
FK
FK
FK
FK
FK
FK
FK
FK
FK
FK
FK
FK
FK
FK
FK
FK
FK
FK
FK
FK
FK
FK
FK
FK
FK
FK
FK
FK
FK
FK
FK
FK
FK
FK
FK
FK
FK
FK
FK
FK
FK
FK
FK
FK
FK
FK
FK
FK
FK
FK
FK
FK
FK
FK
FK
FK
"}
(35,1,1) = {"
FK
FK
FK
FK
FK
FK
FK
FK
FK
FK
FK
FK
FK
FK
FK
FK
FK
FK
FK
FK
FK
FK
FK
FK
FK
FK
FK
FK
FK
FK
FK
FK
FK
FK
FK
FK
FK
FK
FK
FK
FK
FK
FK
FK
FK
FK
FK
FK
FK
FK
FK
FK
FK
FK
FK
FK
FK
FK
FK
FK
FK
FK
FK
FK
"}
(36,1,1) = {"
FK
FK
FK
FK
FK
FK
FK
FK
FK
FK
FK
FK
FK
FK
FK
FK
FK
FK
FK
FK
FK
FK
FK
FK
FK
FK
FK
FK
FK
FK
FK
FK
FK
FK
FK
FK
FK
FK
FK
FK
FK
FK
FK
FK
FK
FK
FK
FK
FK
FK
FK
FK
FK
FK
FK
FK
FK
FK
FK
FK
FK
FK
FK
FK
"}
(37,1,1) = {"
FK
FK
FK
FK
FK
FK
FK
FK
FK
FK
FK
FK
FK
FK
FK
FK
FK
FK
FK
FK
FK
FK
FK
FK
FK
FK
FK
FK
FK
FK
FK
FK
FK
FK
FK
FK
FK
FK
FK
FK
FK
FK
FK
FK
FK
FK
FK
FK
FK
FK
FK
FK
FK
FK
FK
FK
FK
FK
FK
FK
FK
FK
FK
FK
"}
(38,1,1) = {"
FK
FK
FK
FK
FK
FK
FK
FK
FK
FK
FK
FK
FK
FK
FK
FK
FK
FK
FK
FK
FK
FK
FK
FK
FK
FK
FK
FK
FK
FK
FK
FK
FK
FK
FK
FK
FK
FK
FK
FK
FK
FK
FK
FK
FK
FK
FK
FK
FK
FK
FK
FK
FK
FK
FK
FK
FK
FK
FK
FK
FK
FK
FK
FK
"}
(39,1,1) = {"
FK
FK
FK
FK
FK
FK
FK
FK
FK
FK
FK
FK
FK
FK
FK
FK
FK
FK
FK
FK
FK
FK
FK
FK
FK
FK
FK
FK
FK
FK
FK
FK
FK
FK
FK
FK
FK
FK
FK
FK
FK
FK
FK
FK
FK
FK
FK
FK
FK
FK
FK
FK
FK
FK
FK
FK
FK
FK
FK
FK
FK
FK
FK
FK
"}
(40,1,1) = {"
FK
FK
FK
FK
FK
FK
FK
FK
FK
FK
FK
FK
FK
FK
FK
FK
FK
FK
FK
FK
FK
FK
FK
FK
FK
FK
FK
FK
FK
FK
FK
FK
FK
FK
FK
FK
FK
FK
FK
FK
FK
FK
FK
FK
FK
FK
FK
FK
FK
FK
FK
FK
FK
FK
FK
FK
FK
FK
FK
FK
FK
FK
FK
FK
"}
(41,1,1) = {"
FK
FK
FK
FK
FK
FK
FK
FK
FK
FK
FK
FK
FK
FK
FK
FK
FK
FK
FK
FK
FK
FK
FK
FK
FK
FK
FK
FK
FK
FK
FK
FK
FK
FK
FK
FK
FK
FK
FK
FK
FK
FK
FK
FK
FK
FK
FK
FK
FK
FK
FK
FK
FK
FK
FK
FK
FK
FK
FK
FK
FK
FK
FK
FK
"}
(42,1,1) = {"
FK
FK
FK
FK
FK
FK
FK
FK
FK
FK
FK
FK
FK
FK
FK
FK
FK
FK
FK
FK
FK
FK
FK
FK
FK
FK
FK
FK
FK
FK
FK
FK
FK
FK
FK
FK
FK
FK
FK
FK
FK
FK
FK
FK
FK
FK
FK
FK
FK
FK
FK
FK
FK
FK
FK
FK
FK
FK
FK
FK
FK
FK
FK
FK
"}
(43,1,1) = {"
FK
FK
FK
FK
FK
FK
FK
FK
FK
FK
FK
FK
FK
FK
FK
FK
FK
FK
FK
FK
FK
FK
FK
FK
FK
FK
FK
FK
FK
FK
FK
FK
FK
FK
FK
FK
FK
FK
FK
FK
FK
FK
FK
FK
FK
FK
FK
FK
FK
FK
FK
FK
FK
FK
FK
FK
FK
FK
FK
FK
FK
FK
FK
FK
"}
(44,1,1) = {"
FK
FK
FK
FK
FK
FK
FK
FK
FK
FK
FK
FK
FK
FK
FK
FK
FK
FK
FK
FK
FK
FK
FK
FK
FK
FK
FK
FK
FK
FK
FK
FK
FK
FK
FK
FK
FK
FK
FK
FK
FK
FK
FK
FK
FK
FK
FK
FK
FK
FK
FK
FK
FK
FK
FK
FK
FK
FK
FK
FK
FK
FK
FK
FK
"}
(45,1,1) = {"
FK
FK
FK
FK
FK
FK
FK
FK
FK
FK
FK
FK
FK
FK
FK
FK
FK
FK
FK
FK
FK
FK
FK
FK
FK
FK
FK
FK
FK
FK
FK
FK
FK
FK
FK
FK
FK
FK
FK
FK
FK
FK
FK
FK
FK
FK
FK
FK
FK
FK
FK
FK
FK
FK
FK
FK
FK
FK
FK
FK
FK
FK
FK
FK
"}
(46,1,1) = {"
FK
FK
FK
FK
FK
FK
FK
FK
FK
FK
FK
FK
FK
FK
FK
FK
FK
FK
FK
FK
FK
FK
FK
FK
FK
FK
FK
FK
FK
FK
FK
FK
FK
FK
FK
FK
FK
FK
FK
FK
FK
FK
FK
FK
FK
FK
FK
FK
FK
FK
FK
FK
FK
FK
FK
FK
FK
FK
FK
FK
FK
FK
FK
FK
"}
(47,1,1) = {"
FK
FK
FK
FK
FK
FK
FK
FK
FK
FK
FK
FK
FK
FK
FK
FK
FK
FK
FK
FK
FK
FK
FK
FK
FK
FK
FK
FK
FK
FK
FK
FK
FK
FK
FK
FK
FK
FK
FK
FK
FK
FK
FK
FK
FK
FK
FK
FK
FK
FK
FK
FK
FK
FK
FK
FK
FK
FK
FK
FK
FK
FK
FK
FK
"}
(48,1,1) = {"
FK
FK
FK
FK
FK
FK
FK
FK
FK
FK
FK
FK
FK
FK
FK
FK
FK
FK
FK
FK
FK
FK
FK
FK
FK
FK
FK
FK
FK
FK
FK
FK
FK
FK
FK
FK
FK
FK
FK
FK
FK
FK
FK
FK
FK
FK
FK
FK
FK
FK
FK
FK
FK
FK
FK
FK
FK
FK
FK
FK
FK
FK
FK
FK
"}
(49,1,1) = {"
FK
FK
FK
FK
FK
FK
FK
FK
FK
FK
FK
FK
FK
FK
FK
FK
FK
FK
FK
FK
FK
FK
FK
FK
FK
FK
FK
FK
FK
FK
FK
FK
FK
FK
FK
FK
FK
FK
FK
FK
FK
FK
FK
FK
FK
FK
FK
FK
FK
FK
FK
FK
FK
FK
FK
FK
FK
FK
FK
FK
FK
FK
FK
FK
"}
(50,1,1) = {"
FK
FK
FK
FK
FK
FK
FK
FK
FK
FK
FK
FK
FK
FK
FK
FK
FK
FK
FK
FK
FK
FK
FK
FK
FK
FK
FK
FK
FK
FK
FK
FK
FK
FK
FK
FK
FK
FK
FK
FK
FK
FK
FK
FK
FK
FK
FK
FK
FK
FK
FK
FK
FK
FK
FK
FK
FK
FK
FK
FK
FK
FK
FK
FK
"}
(51,1,1) = {"
FK
FK
FK
FK
FK
FK
FK
FK
FK
FK
FK
FK
FK
FK
FK
FK
FK
FK
FK
FK
FK
FK
FK
FK
FK
FK
FK
FK
FK
FK
FK
FK
FK
FK
FK
FK
FK
FK
FK
FK
FK
FK
FK
FK
FK
FK
FK
FK
FK
FK
FK
FK
FK
FK
FK
FK
FK
FK
FK
FK
FK
FK
FK
FK
"}
(52,1,1) = {"
FK
FK
FK
FK
FK
FK
FK
FK
FK
FK
FK
FK
FK
FK
FK
FK
FK
FK
FK
FK
FK
FK
FK
FK
FK
FK
FK
FK
FK
FK
FK
FK
FK
FK
FK
FK
FK
FK
FK
FK
FK
FK
FK
FK
FK
FK
FK
FK
FK
FK
FK
FK
FK
FK
FK
FK
FK
FK
FK
FK
FK
FK
FK
FK
"}
(53,1,1) = {"
FK
FK
FK
FK
FK
FK
FK
FK
FK
FK
FK
FK
FK
FK
FK
FK
FK
FK
FK
FK
FK
FK
FK
FK
FK
FK
FK
FK
FK
FK
FK
FK
FK
FK
FK
FK
FK
FK
FK
FK
FK
FK
FK
FK
FK
FK
FK
FK
FK
FK
FK
FK
FK
FK
FK
FK
FK
FK
FK
FK
FK
FK
FK
FK
"}
(54,1,1) = {"
FK
FK
FK
FK
FK
FK
FK
FK
FK
FK
FK
FK
FK
FK
FK
FK
FK
FK
FK
FK
FK
FK
FK
FK
FK
FK
FK
FK
FK
FK
FK
FK
FK
FK
FK
FK
FK
FK
FK
FK
FK
FK
FK
FK
FK
FK
FK
FK
FK
FK
FK
FK
FK
FK
FK
FK
FK
FK
FK
FK
FK
FK
FK
FK
"}
(55,1,1) = {"
FK
FK
FK
FK
FK
FK
FK
FK
FK
FK
FK
FK
FK
FK
FK
FK
FK
FK
FK
FK
FK
FK
FK
FK
FK
FK
FK
FK
FK
FK
FK
FK
FK
FK
FK
FK
FK
FK
FK
FK
FK
FK
FK
FK
FK
FK
FK
FK
FK
FK
FK
FK
FK
FK
FK
FK
FK
FK
FK
FK
FK
FK
FK
FK
"}
(56,1,1) = {"
FK
FK
FK
FK
FK
FK
FK
FK
FK
FK
FK
FK
FK
FK
FK
FK
FK
FK
FK
FK
FK
FK
FK
FK
FK
FK
FK
FK
FK
FK
FK
FK
FK
FK
FK
FK
FK
FK
FK
FK
FK
FK
FK
FK
FK
FK
FK
FK
FK
FK
FK
FK
FK
FK
FK
FK
FK
FK
FK
FK
FK
FK
FK
FK
"}
(57,1,1) = {"
FK
FK
FK
FK
FK
FK
FK
FK
FK
FK
FK
FK
FK
FK
FK
FK
FK
FK
FK
FK
FK
FK
FK
FK
FK
FK
FK
FK
FK
FK
FK
FK
FK
FK
FK
FK
FK
FK
FK
FK
FK
FK
FK
FK
FK
FK
FK
FK
FK
FK
FK
FK
FK
FK
FK
FK
FK
FK
FK
FK
FK
FK
FK
FK
"}
(58,1,1) = {"
FK
FK
FK
FK
FK
FK
FK
FK
FK
FK
FK
FK
FK
FK
FK
FK
FK
FK
FK
FK
FK
FK
FK
FK
FK
FK
FK
FK
FK
FK
FK
FK
FK
FK
FK
FK
FK
FK
FK
FK
FK
FK
FK
FK
FK
FK
FK
FK
FK
FK
FK
FK
FK
FK
FK
FK
FK
FK
FK
FK
FK
FK
FK
FK
"}
(59,1,1) = {"
FK
FK
FK
FK
FK
FK
FK
FK
FK
FK
FK
FK
FK
FK
FK
FK
FK
FK
FK
FK
FK
FK
FK
FK
FK
FK
FK
FK
FK
FK
FK
FK
FK
FK
FK
FK
FK
FK
FK
FK
FK
FK
FK
FK
FK
FK
FK
FK
FK
FK
FK
FK
FK
FK
FK
FK
FK
FK
FK
FK
FK
FK
FK
FK
"}
(60,1,1) = {"
FK
FK
FK
FK
FK
FK
FK
FK
FK
FK
FK
FK
FK
FK
FK
FK
FK
FK
FK
FK
FK
FK
FK
FK
FK
FK
FK
FK
FK
FK
FK
FK
FK
FK
FK
FK
FK
FK
FK
FK
FK
FK
FK
FK
FK
FK
FK
FK
FK
FK
FK
FK
FK
FK
FK
FK
FK
FK
FK
FK
FK
FK
FK
FK
"}
(61,1,1) = {"
FK
FK
FK
FK
FK
FK
FK
FK
FK
FK
FK
FK
FK
FK
FK
FK
FK
FK
FK
FK
FK
FK
FK
FK
FK
FK
FK
FK
FK
FK
FK
FK
FK
FK
FK
FK
FK
FK
FK
FK
FK
FK
FK
FK
FK
FK
FK
FK
FK
FK
FK
FK
FK
FK
FK
FK
FK
FK
FK
FK
FK
FK
FK
FK
"}
(62,1,1) = {"
FK
FK
FK
FK
FK
FK
FK
FK
FK
FK
FK
FK
FK
FK
FK
FK
FK
FK
FK
FK
FK
FK
FK
FK
FK
FK
FK
FK
FK
FK
FK
FK
FK
FK
FK
FK
FK
FK
FK
FK
FK
FK
FK
FK
FK
FK
FK
FK
FK
FK
FK
FK
FK
FK
FK
FK
FK
FK
FK
FK
FK
FK
FK
FK
"}
(63,1,1) = {"
FK
FK
FK
FK
FK
FK
FK
FK
FK
FK
FK
FK
FK
FK
FK
FK
FK
FK
FK
FK
FK
FK
FK
FK
FK
FK
FK
FK
FK
FK
FK
FK
FK
FK
FK
FK
FK
FK
FK
FK
FK
FK
FK
FK
FK
FK
FK
FK
FK
FK
FK
FK
FK
FK
FK
FK
FK
FK
FK
FK
FK
FK
FK
FK
"}
(64,1,1) = {"
FK
FK
FK
FK
FK
FK
FK
FK
FK
FK
FK
FK
FK
FK
FK
FK
FK
FK
FK
FK
FK
FK
FK
FK
FK
FK
FK
FK
FK
FK
FK
FK
FK
FK
FK
FK
FK
FK
FK
FK
FK
FK
FK
FK
FK
FK
FK
FK
FK
FK
FK
FK
FK
FK
FK
FK
FK
FK
FK
FK
FK
FK
FK
FK
"}
